6 5
WWWWWWWWWW
WFHFFFWFFW
WWWWFRWHFW
WFHWFRWWFW
WFFFRRWFFW
WFWRRWFFFW
WFWRFWFWFW
WHRRFFFWFW
WFRRRFFWFW
WWFWWWWWWW
